11111111
11P00001
11000111
11101111
11101111
11E0C111
11111111
