11111111
11P00001
11011C11
11001111
11E000C1
11111111
